20 25
####################
#..................#
#....#.............#
#....#.............#
#....#######.......#
#....#.....#.......#
#..........#.......#
#..........#.......#
#....#.............#
#....#.......#####.#
#....#.......#.....#
#............#.....#
#..................#
#........######....#
#..................#
#..................#
#..................#
#....#.............#
#....#.............#
#....#.............#
#..######..........#
#..#...............#
#..#...............#
#..................#
####################
